#############/#
#     |       #
#     #       #
#     #       #
#######       #
#     _       #
###############